zyborg=Looksmart
googlebot=Google
mediapartners-google=Google Adsense
teoma=Teoma
jeeves=Ask Jeeves
ultraseek=Infoseek
ia_archiver=Alexa/Archive.org
msnbot=Bing/MSN
bingbot=Bing
mantraagent=Looksmart
wisenutbot=Looksmart
paros=Paros
sqworm=Aol.com
baidu=Baidu
facebookexternalhit=Facebook
yandex=Yandex
daum=Daum
ahrefsbot=Ahrefs
mj12bot=Majestic-12
blexbot=webmeup
duckduckbot=DuckDuckGo
semrushbot=Semrush
twitterbot=Twitter
exabot=Exalead
petalbot=Huawei
coccocbot=Coc Coc
slurp=Yahoo
applebot=Apple
uptimerobot=UptimeRobot
discordbot=Discord
linkedinbot=LinkedIn
bytespider=ByteDance
datanyze=Datanyze
rogerbot=Moz
dotbot=DotBot
seoscanners=SEO Scanners
sitebulb=Sitebulb
screaming frog seo spider=Screaming Frog
